111111111111111111111111111111
1 p 1 1 1 2   11     2       1
11 11 1 1 2          2 1 1 1 1
1   1     2 2222     2       1
11 11     222  222   2  1 1  1
1   11   222    2    2       1
11 11     2          2 1 1 1 1
1         2      2   2       1
1   22    2      2      1 1  1
12222  2222      2           1
1 222  2  2      22222 1 1 1 1
1     1   2   22 21112       1
1 11111   2  22  2   2       1
1 2   1 2 2  22  2   2222222 1
1 2   1 2 2 22   2      2  2 1
1 2   1 2 2      2   2  2  2 1
1 222 1 2 2      2 2 2 2 2 2 1
1 2 2 1 2 2      2   2 2   2 1
1   2 1 2 22    222 22 2 2 2 1
1   2 1 2 222  222   2 2 2 2 1
1   2 1 2 2   22 2   2 2 2   1
1     1 2 2 22 2 22 22       1
12222 1 2 2      2   2       1
1 2   1 2 2  2 2 2   222222221
1 2   1 2 2      22 2        1
1 2   1 2 2  2 2 2           1
1     1 2 2      2   2       1
1     1 2 2  2 2 2   2 22    1
1     1 2 2      2   2  2    1
1 2   1 2 2      2   2  2222 1
1 2   1 2 222222 2           1
1 2   1 2   2    2           1
1 2   1 2   2    2     22    1
1 22221 22  22 222   2  2    1
1       2    2   2   2  2 22 1
111111112    2   2   2  2 2  1
1111111122  2222 2   2 22 2  1
122222112    2   2 2 2    22 1
1    2112    2   2           1
1    21122  22 222  222 2 2  1
1    2112    2   2           1
1 22 2112    2   2 2  2222   1
1 22 22222  2222 2 2  2  2   1
1 22         2   2 2         1
1 22         2   2 2         1
1 22 222     222 2 2  2  2   1
1 22 2111 2222   2 2  2222   1
1    211         2           1
1    211         2           1
1    211     2   2           1
111111111111111111111111111111
