Map Width: 38
Map Height: 33
Next Level: None

0 0 0 0 0 0 0 0 0 0 0 0 0 0 0 0 0 0 0 0 0 0 0 0 0 0 0 0 0 0 0 0 0 0 0 0 0 0
0 1 1 0 1 0 1 1 1 1 0 1 1 1 1 1 0 0 0 0 0 0 1 1 1 1 1 1 1 1 1 1 1 1 1 0 1 0
0 1 1 1 1 0 0 1 1 1 0 1 1 1 1 1 0 0 0 0 0 0 1 1 1 1 1 1 1 1 1 1 1 1 1 1 1 0
0 0 0 0 1 0 0 1 0 0 0 0 0 1 1 1 0 0 0 0 0 0 1 1 1 1 1 1 1 1 1 1 1 1 1 0 1 0
0 1 1 1 1 1 1 1 1 1 1 1 0 0 1 0 0 1 1 1 1 0 1 1 1 1 1 1 1 1 1 1 1 1 1 0 1 0
0 1 1 1 1 1 1 1 1 1 1 1 0 1 1 1 1 1 1 1 1 0 1 1 1 1 1 1 1 1 1 1 1 1 1 0 1 0
0 1 1 1 1 1 1 1 1 1 1 1 1 1 1 1 1 1 1 1 1 0 1 1 1 1 1 1 1 1 1 1 1 1 1 0 1 0
0 0 0 0 1 0 0 0 0 0 0 0 0 0 0 0 0 0 0 0 1 0 1 1 1 1 1 1 1 1 1 1 1 1 1 0 1 0
0 1 1 1 1 1 1 1 1 1 1 1 1 1 1 1 0 0 0 0 1 0 1 1 1 1 1 1 1 1 1 1 1 1 1 0 1 0
0 1 1 1 1 1 1 1 1 1 1 1 1 1 1 1 0 0 0 0 0 0 1 1 1 1 1 1 1 1 1 1 1 1 1 0 1 0
0 1 1 1 0 0 1 1 1 1 1 0 0 1 1 1 0 0 0 0 0 0 1 1 1 1 1 1 1 1 1 1 1 1 1 0 1 0
0 1 1 1 0 0 1 1 1 1 1 0 0 1 1 1 0 0 0 0 0 0 1 1 1 1 1 1 1 1 1 1 1 1 1 0 1 0
0 1 1 1 1 1 1 1 1 1 1 1 1 1 1 1 0 0 0 0 0 0 1 1 1 1 1 1 1 1 1 1 1 1 1 0 1 0
0 0 0 0 1 1 1 1 1 1 1 1 1 1 1 1 0 0 0 0 0 0 1 1 1 1 1 1 1 1 1 1 1 1 1 0 1 0
0 1 1 0 0 0 0 0 1 0 0 0 0 1 0 0 0 0 0 0 0 0 1 1 1 1 1 1 1 1 1 1 1 1 1 0 1 0
0 1 1 1 1 1 0 1 1 1 0 0 0 1 0 0 0 0 0 0 0 0 1 1 1 1 1 1 1 1 1 1 1 1 1 0 1 0
0 1 1 1 0 0 1 1 1 1 1 0 0 0 0 0 0 0 0 0 0 0 0 0 0 0 0 0 0 0 0 0 0 1 0 0 1 0
0 1 1 1 0 1 1 1 1 1 1 1 0 1 1 1 1 1 1 1 1 1 1 1 1 1 1 1 1 1 1 1 1 1 1 0 1 0
0 1 1 1 1 1 1 1 1 1 1 1 1 1 1 1 1 1 1 1 1 1 1 1 1 1 1 1 1 1 1 1 1 1 1 0 1 0
0 1 1 1 0 1 1 1 1 1 1 1 0 1 1 1 1 1 1 1 1 1 1 1 1 1 1 1 1 1 1 1 1 1 1 0 1 0
0 1 1 1 0 0 1 1 1 1 1 0 0 0 0 0 0 0 0 0 0 0 0 0 0 0 0 0 0 0 0 0 0 0 0 0 1 0
0 1 1 1 1 0 0 1 1 1 0 0 0 0 1 1 1 1 1 1 1 1 1 1 1 1 1 1 1 1 1 1 1 1 1 1 1 0
0 1 1 0 0 0 0 0 1 0 0 1 1 1 1 1 1 1 1 1 1 0 0 0 0 0 0 0 0 1 1 1 1 1 1 1 1 0
0 0 0 0 1 1 1 0 1 0 0 0 0 0 1 1 1 1 1 1 0 1 1 1 1 1 1 1 0 0 0 0 0 0 0 0 0 0
1 1 1 1 1 1 1 0 1 0 0 0 1 0 0 1 1 1 1 0 1 1 1 1 1 1 1 1 0 0 0 0 0 0 0 0 0 0
1 1 1 1 1 1 1 0 1 0 0 0 1 1 0 0 1 1 0 1 1 1 1 1 1 1 1 1 0 0 0 0 0 0 0 0 0 0
1 1 1 1 1 1 1 0 1 0 0 0 1 1 0 0 0 0 1 1 1 1 1 1 1 1 1 1 0 0 0 0 0 0 0 0 0 0
1 1 1 1 1 1 1 0 1 1 1 1 1 1 1 1 1 1 1 0 1 1 1 1 1 1 1 1 0 0 0 0 0 0 0 0 0 0
1 1 1 1 1 1 0 0 1 0 0 0 1 1 0 0 0 0 1 1 1 1 1 1 1 1 1 1 0 0 0 0 0 0 0 0 0 0
1 1 1 1 1 1 0 1 1 1 1 0 1 1 0 1 1 1 0 1 1 1 1 1 1 1 1 1 0 0 0 0 0 0 0 0 0 0
1 1 1 1 1 1 0 1 1 1 1 0 1 0 0 1 1 1 1 0 1 1 1 1 1 1 1 1 0 0 0 0 0 0 0 0 0 0
1 1 1 1 1 1 0 0 0 0 0 0 0 0 1 1 1 1 1 1 0 1 1 1 1 1 1 1 0 0 0 0 0 0 0 0 0 0
1 1 1 1 1 1 1 1 1 1 1 1 1 1 1 1 1 1 1 1 1 0 0 0 0 0 0 0 0 0 0 0 0 0 0 0 0 0
1 1 1 1 1 1 1 1 1 1 1 1 1 1 1 1 1 1 1 1 1 1 1 1 1 1 1 1 1 1 1 1 1 1 1 1 1 1
1 q 0 1 ! 1 w ! 0 Z 1 F 0 O 0 S 1 1 1 1 1 1 @ 0 0 0 0 0 0 0 0 0 0 0 @ 1 0 1
1 Z 0 0 0 1 1 0 0 S 1 0 0 0 0 D 1 1 1 1 1 1 0 0 0 0 0 0 0 0 * 0 0 0 0 0 0 1
1 1 1 1 0 1 1 0 1 1 1 1 1 # 0 0 1 1 1 1 1 1 0 0 * 0 0 0 0 0 0 0 0 0 0 1 0 1
1 Z 0 Z 0 0 0 * 0 0 Z ! 1 1 0 1 1 0 ! Z 0 1 0 0 0 0 0 * 0 0 0 0 0 0 0 1 0 1
1 0 * 0 0 ! 0 0 Z 0 0 0 1 0 0 * ! 0 Z 0 Z 1 0 0 0 0 0 0 0 0 0 0 0 * 0 1 0 1
1 0 0 0 0 0 Z 0 ! * 0 0 0 0 0 0 0 Z 0 * ! 1 0 0 0 0 0 * 0 0 0 * 0 * 0 1 0 1
1 1 1 1 0 1 1 1 1 1 1 1 1 1 1 1 1 1 1 1 [ 1 0 0 * 0 0 0 0 0 0 0 0 0 0 1 0 1
1 0 0 0 0 0 Z 0 0 0 0 0 0 0 Z 0 1 1 1 1 w 1 0 0 0 0 0 0 0 N 0 0 0 0 0 1 0 1
1 ! 0 Z 0 0 ! 0 0 Z ! 0 0 ! 0 0 1 1 1 1 1 1 0 0 0 * 0 0 0 0 * 0 0 0 0 1 0 1
1 0 0 0 1 1 0 0 0 0 0 1 1 0 0 0 1 1 1 1 1 1 0 0 0 0 0 0 0 0 0 0 0 0 0 1 0 1
1 Z 0 0 1 1 0 0 ! Z 0 1 1 0 0 ! 1 1 1 1 1 1 0 0 0 0 0 0 0 0 0 0 0 0 0 1 0 1
1 0 0 ! 0 0 Z 0 0 0 0 0 0 0 Z 0 1 1 1 1 1 1 0 0 0 0 0 0 0 0 0 * 0 0 0 1 0 1
1 1 1 1 0 0 0 0 Z 0 0 0 0 0 0 ! 1 1 1 1 1 1 0 0 * 0 * 0 0 0 0 0 0 0 0 1 0 1
1 C 0 1 1 1 1 1 0 1 1 1 1 [ 1 1 1 1 1 1 1 1 0 0 0 0 0 0 0 0 0 0 0 0 0 1 0 1
1 * 0 q [ w 1 # 0 # 1 1 1 F 1 1 1 1 1 1 1 1 @ 0 0 * 0 0 0 0 0 0 0 0 @ 1 0 1
1 0 0 0 1 1 ! 0 0 0 ! 1 1 1 1 1 1 1 1 1 1 1 1 1 1 1 1 1 1 1 1 1 1 0 1 1 0 1
1 0 * 0 1 # 0 0 * 0 0 @ 1 0 0 0 0 0 0 @ w w 0 @ F F @ S @ 0 @ 0 @ 0 @ 1 0 1
1 D 0 0 0 * 0 0 B 0 0 0 0 0 * 0 * 0 0 * 0 0 * 0 0 0 * 0 0 0 0 * 0 0 0 1 0 1
1 0 0 0 1 # 0 0 0 * 0 @ 1 0 0 0 0 0 0 @ q q 0 @ D D @ S @ 0 @ 0 0 0 0 1 0 1
1 0 0 0 1 1 ! 0 0 0 ! 1 1 1 1 1 1 1 1 1 1 1 1 1 1 1 1 1 1 1 1 1 1 1 1 1 0 1
1 * 0 0 W 1 1 # 0 # 1 1 1 1 @ Z 0 0 Z C 0 0 0 0 0 0 0 0 0 X 0 0 0 0 0 0 0 1
1 C * 1 1 1 1 1 * 1 1 0 0 ] 0 0 0 0 Z 0 0 1 1 1 1 1 1 1 1 0 0 X 0 0 0 0 0 1
1 1 1 1 0 0 0 1 0 1 1 1 1 1 @ 0 0 0 0 0 1 0 0 * 0 V 0 F 1 1 1 1 1 1 1 1 1 1
0 0 0 0 0 0 0 1 0 1 1 1 0 1 1 Z 0 Z 0 1 0 0 0 0 0 0 B 0 1 0 0 0 0 0 0 0 0 0
0 0 0 0 0 0 0 1 0 1 1 1 0 0 1 1 q w 1 0 0 0 0 0 0 * 0 0 1 0 0 0 0 0 0 0 0 0
0 0 0 0 0 0 0 1 * 1 1 1 0 # 1 1 1 1 0 * * 0 0 0 0 0 0 C 1 0 0 0 0 0 0 0 0 0
0 0 0 0 0 0 0 1 0 0 * 0 0 0 * 0 0 * * 1 0 0 * 0 0 0 0 0 1 0 0 0 0 0 0 0 0 0
0 0 0 0 0 0 1 1 ! 1 1 1 0 # 1 1 1 1 0 0 0 0 0 0 0 * 0 C 1 0 0 0 0 0 0 0 0 0
0 0 0 0 0 0 1 S 0 0 q 1 0 0 1 0 0 0 1 0 0 0 0 * 0 0 0 * 1 0 0 0 0 0 0 0 0 0
0 0 0 0 0 0 1 S 0 0 q 1 0 1 1 0 0 0 0 1 0 * 0 0 0 0 B 0 1 0 0 0 0 0 0 0 0 0
0 0 0 0 0 0 1 1 1 1 1 1 1 1 0 0 0 0 0 0 1 0 0 0 * V 0 F 1 0 0 0 0 0 0 0 0 0
0 0 0 0 0 0 0 0 0 0 0 0 0 0 0 0 0 0 0 0 0 1 1 1 1 1 1 1 1 0 0 0 0 0 0 0 0 0
