1	1	1	1	1	1	1	1	1	1	1
1				1			1	1	1	1
1		p					1	1	1	1
1				1			1	1	1	1
1	1	1	1	1			e		h	1
1	e							2	2	1
1			2	2				2	2	1
1			2	2				2	2	1
1										1
1			2	2	2	2				1
1			2	2				e		1
1					e					1
1			1	1		2	h	2	b	1
1			a	1		2	2	2	2	1
1		e	a	1		2	e			1
1	e		h	1		e			e	1
1			h	1					e	1
1			b	1		1				1
1			b	1		1	e			1
1	1	1	1	1	1	1	1	1	1	1