Map Width: 45
Map Height: 30
Next Level: Level4

0 0 0 0 0 0 0 0 0 0 0 0 0 0 0 0 0 0 0 0 0 0 0 0 0 0 0 0 0 0 0 0 0 0 0 0 0 0 0 0 0 0 0 0 0
0 1 1 1 1 1 1 0 0 0 0 0 0 0 0 0 0 0 0 0 0 0 0 0 0 0 0 0 0 0 0 0 0 0 0 0 0 0 1 0 0 0 1 1 0
0 1 1 1 1 1 1 1 1 1 1 1 1 1 1 0 0 0 0 0 0 0 0 0 0 0 0 0 0 0 0 0 1 0 0 0 0 0 1 0 0 0 1 1 0
0 1 1 1 1 1 1 0 0 0 0 0 0 0 0 0 0 1 1 1 1 1 1 1 1 1 1 1 1 1 1 1 1 1 0 0 0 0 1 0 0 0 1 1 0
0 0 0 1 1 0 0 0 0 0 1 1 1 1 1 1 0 1 1 0 1 1 1 0 1 1 1 0 1 1 1 0 1 1 0 0 0 0 1 0 0 0 1 1 0
0 1 1 1 1 1 1 1 1 1 1 1 1 1 1 1 1 1 1 1 1 1 1 1 1 1 1 1 1 1 1 1 1 1 0 0 0 1 1 1 1 0 1 1 0
0 1 1 1 1 1 1 0 0 1 1 1 1 1 1 1 0 1 1 1 1 1 1 1 1 1 1 1 1 1 1 1 1 1 0 0 0 1 1 1 1 0 1 1 0
0 1 1 1 1 1 1 0 0 1 1 1 1 1 1 1 0 1 1 1 1 1 1 1 1 1 1 1 1 1 1 1 1 1 0 0 0 1 1 1 1 0 1 1 0
0 0 0 0 0 0 0 0 0 1 0 1 1 1 1 1 0 1 1 0 1 1 1 0 1 1 1 0 1 1 1 0 1 1 0 0 0 1 1 1 0 0 1 1 0
0 0 0 0 0 0 0 0 0 1 0 1 1 1 1 1 0 1 1 1 1 1 1 1 1 1 1 1 1 1 1 1 1 1 0 0 0 0 1 0 0 0 1 1 0
0 0 0 0 1 1 1 0 0 0 0 0 1 1 1 1 0 1 1 1 1 1 1 1 1 1 1 1 1 1 1 1 1 1 0 1 1 1 1 1 1 1 1 1 0
0 0 0 0 1 0 1 1 0 0 0 0 0 1 1 1 0 1 1 1 1 1 1 1 1 1 1 1 1 1 1 1 1 1 0 1 1 1 1 1 1 1 1 1 0
0 1 0 0 1 0 1 1 1 0 0 0 0 1 1 1 0 1 1 0 1 1 1 0 1 1 1 0 1 1 1 0 1 1 0 1 0 1 1 0 1 1 0 1 0
0 1 1 0 0 0 0 1 1 0 0 0 0 1 1 1 0 1 1 1 1 1 1 1 1 1 1 1 1 1 1 1 1 1 0 1 1 1 1 1 1 1 1 1 0
0 1 1 1 1 1 0 1 1 0 0 0 0 0 0 0 0 0 0 0 0 0 0 0 1 1 1 0 0 0 0 0 0 0 0 1 1 1 1 1 1 1 1 1 0
0 0 0 1 1 1 1 1 1 0 0 0 0 0 0 0 0 0 0 0 0 0 0 0 0 1 0 0 1 1 1 1 1 1 1 1 0 1 1 0 1 1 0 1 0
0 1 0 1 1 1 1 1 1 1 0 0 0 0 0 0 0 0 0 0 0 0 0 0 1 1 1 0 0 1 1 1 1 1 0 1 1 1 1 1 1 1 1 1 0
0 1 0 0 1 1 1 1 1 1 1 0 0 0 0 0 0 0 0 0 0 0 0 1 1 0 1 1 0 0 1 1 1 1 0 1 1 1 1 1 1 1 1 1 0
0 1 0 0 1 1 1 1 1 1 1 0 0 0 0 0 0 0 0 0 0 0 1 1 1 1 1 1 1 0 0 0 0 0 0 1 0 1 1 0 1 1 0 1 0
0 1 0 0 1 1 1 1 1 1 1 0 0 0 0 1 1 0 0 0 0 1 1 1 1 1 1 1 1 1 0 0 0 0 0 1 1 1 1 1 1 1 1 1 0
0 1 0 0 1 1 1 1 1 1 1 0 0 0 1 1 1 1 0 0 0 1 1 1 1 1 1 1 1 1 0 0 0 0 0 0 1 1 1 1 1 0 0 1 0
0 1 0 0 1 1 1 1 1 1 1 1 1 1 1 1 1 1 1 1 1 1 1 1 1 1 1 1 1 1 1 0 0 0 1 0 0 0 0 0 1 1 0 1 0
0 1 0 0 1 1 1 1 1 1 1 1 1 1 1 1 1 1 1 1 1 1 1 1 1 1 1 1 1 1 1 1 0 0 1 0 0 0 0 0 0 1 0 0 0
0 1 0 0 0 1 0 0 0 0 0 0 0 0 1 1 1 0 0 0 0 1 1 1 1 1 1 1 1 1 0 1 1 0 1 1 1 1 1 1 0 1 0 1 0
0 1 0 0 0 1 1 1 1 1 1 0 0 0 0 0 0 0 0 0 0 0 1 1 1 1 1 0 0 0 0 1 1 1 1 1 1 1 1 1 1 1 1 1 0
0 1 0 0 0 1 1 1 1 1 1 0 0 0 0 0 0 0 0 0 0 0 0 0 0 0 0 0 1 1 1 1 1 1 1 1 1 1 1 1 1 1 1 1 0
0 1 0 0 1 1 0 0 0 0 1 0 0 0 0 0 0 0 0 0 0 0 0 0 1 1 1 1 1 0 0 0 1 1 1 1 1 1 1 1 1 1 1 1 0
0 1 0 0 0 0 0 0 0 0 1 0 0 0 0 0 0 0 0 0 1 1 1 0 1 0 0 0 0 0 0 0 0 1 1 1 1 1 1 1 1 1 1 1 0
0 1 1 1 1 1 1 1 1 1 1 0 0 0 0 0 0 0 0 0 1 1 1 1 1 0 0 0 0 0 0 0 1 1 1 1 1 1 1 1 1 1 1 1 0
0 0 0 0 0 0 0 0 0 0 0 0 0 0 0 0 0 0 0 0 0 0 0 0 0 0 0 0 0 0 0 0 0 0 0 0 0 0 0 0 0 0 0 0 0
2 2 2 2 2 2 2 2 1 1 1 1 1 1 1 1 1 1 1 1 1 1 1 1 1 1 1 1 1 1 1 1 1 1 1 1 1 1 1 1 1 1 1 1 1
2 0 ! 0 0 0 @ 2 2 2 2 2 2 2 2 2 1 1 1 1 1 1 1 1 1 1 1 1 1 1 1 1 2 1 1 1 1 1 0 1 1 1 0 0 1
2 0 0 0 0 0 0 O ] 0 0 0 0 0 0 2 2 2 2 2 2 2 2 2 2 2 2 2 2 2 2 2 q 2 2 1 1 1 0 1 1 1 Z ! 1
2 0 ! 0 0 0 @ 2 2 2 2 2 2 2 2 2 2 0 Z 0 0 * 0 0 0 0 0 0 0 0 0 0 0 0 2 1 1 1 ] 1 1 1 0 0 1
2 2 2 0 0 2 2 2 2 2 0 0 0 Z 0 @ 2 0 0 2 0 ! 0 2 0 0 0 2 0 0 0 2 0 0 2 1 1 1 V 1 1 1 0 Z 1
1 0 0 0 0 0 0 0 0 0 0 0 0 0 0 0 0 0 0 0 0 0 0 0 0 Z 0 0 0 0 0 0 0 0 2 1 1 @ 0 @ 0 1 ! 0 1
1 0 0 0 0 0 Z 1 1 0 0 0 0 0 0 @ 2 0 0 0 0 0 0 0 0 0 Z 0 * 0 0 ! 0 Z 2 1 1 0 0 0 0 1 0 0 1
1 0 0 Z 0 0 0 1 1 ! * 0 0 0 0 0 2 0 0 0 0 0 Z 0 0 0 0 0 0 0 0 0 0 0 2 1 1 Z 0 Z 0 1 Z 0 1
1 1 1 1 1 1 1 1 1 [ 1 0 0 ! X Z 2 0 0 2 0 0 0 2 0 0 0 2 0 0 0 2 0 0 2 1 1 0 0 0 1 1 0 0 1
1 1 1 1 1 1 1 1 1 w 1 Z 0 0 0 0 2 0 0 0 ! 0 0 0 0 0 0 0 0 0 0 0 0 0 2 2 2 1 0 1 1 1 0 ! 1
1 2 2 2 q 0 0 2 1 1 1 1 0 0 0 * 2 0 Z * 0 0 0 0 0 Z 0 0 0 0 Z 0 0 0 2 0 0 0 0 0 0 0 0 0 1
1 2 2 2 [ 2 0 0 2 1 1 1 2 0 * 0 2 0 0 0 0 Z 0 0 0 0 0 0 0 0 0 0 * 0 2 0 0 0 0 C 0 0 0 0 1
1 0 2 2 w 2 0 0 0 1 1 1 2 # d # 2 0 0 2 0 0 0 2 0 0 0 2 0 Z 0 2 0 0 2 0 2 0 0 2 0 0 2 0 1
1 Z 0 2 2 2 2 0 Z 1 1 1 2 ! D ! 2 0 0 0 0 0 0 0 0 0 0 0 0 0 0 0 ! 0 2 0 0 0 0 0 0 0 0 0 1
1 0 0 0 0 0 2 Z 0 1 1 1 2 2 2 2 2 2 2 2 2 2 2 2 0 C 0 2 2 2 2 2 2 2 2 0 0 0 0 0 0 0 0 0 1
1 2 2 0 0 0 0 0 0 2 1 1 1 1 1 1 1 1 1 1 1 1 1 2 2 0 2 2 ! Z 0 0 0 0 0 0 2 0 0 2 0 0 2 0 1
1 q 2 0 Z ! 0 0 Z 0 2 1 1 1 1 1 1 1 1 1 1 1 2 2 0 0 0 2 2 0 0 ! 0 0 2 C 0 0 0 0 0 0 0 0 1
1 D 2 2 0 0 X 0 0 0 0 1 1 1 1 1 1 1 1 1 1 2 2 0 0 2 0 0 2 2 X 0 0 0 2 0 0 0 0 0 0 0 0 0 1
1 0 2 2 0 Z 0 0 0 0 0 1 1 1 2 2 2 1 1 1 2 2 0 0 0 0 0 0 0 2 2 2 2 2 2 0 2 0 0 2 0 0 2 0 1
1 0 2 2 0 0 0 0 0 0 0 1 1 2 2 0 0 2 1 1 2 0 Z 0 0 0 Z 0 0 0 2 1 1 1 1 0 0 0 0 0 0 0 0 0 1
1 Z 2 2 ! X 0 0 ! 0 0 2 2 2 0 0 0 0 2 2 2 0 0 0 0 ! 0 0 0 0 2 2 1 1 1 1 0 0 0 0 0 1 1 0 1
1 0 2 2 0 0 0 0 0 0 0 0 0 0 0 0 0 0 0 0 ! 0 0 0 X 0 0 0 0 0 0 2 2 2 S 1 1 1 1 1 0 0 1 ! 1
1 0 2 2 X 0 0 0 0 0 0 0 0 ! 0 0 0 0 0 0 0 0 0 0 0 Z 0 Z 0 0 0 0 2 2 [ 2 1 1 1 1 1 0 1 1 1
1 Z 2 2 2 0 2 2 2 2 2 2 2 2 0 0 0 2 2 2 2 0 0 Z 0 0 0 ! X 0 2 0 0 2 0 0 0 0 0 0 1 0 1 q 1
1 Z 2 2 2 0 0 0 0 0 Z 2 1 2 2 2 2 1 1 1 2 2 0 0 0 0 0 2 2 2 2 0 0 0 0 0 0 0 0 0 0 0 0 0 1
1 0 2 2 2 Z 0 0 X Z 0 2 1 1 1 1 1 1 1 1 1 2 2 2 2 2 2 2 0 0 [ 0 0 0 0 0 0 X 0 0 0 0 0 0 1
1 0 2 2 S 0 2 2 2 2 [ 2 1 1 1 1 1 1 1 1 1 1 2 2 0 0 0 0 0 2 2 2 0 0 0 0 0 0 0 0 0 0 0 0 1
1 0 2 2 2 2 2 2 2 2 0 2 1 1 1 1 1 1 1 1 S q w 2 0 2 2 2 2 2 2 2 2 0 X 0 0 0 0 0 X 0 0 0 1
1 0 0 Z 0 Z 0 0 0 0 0 2 1 1 1 1 1 1 1 1 D 0 0 0 0 2 1 1 1 1 2 2 w 0 0 0 0 0 0 0 0 0 X 0 1
1 1 1 1 1 1 1 1 1 1 2 2 1 1 1 1 1 1 1 1 1 1 1 1 1 1 1 1 1 1 1 1 1 1 1 1 1 1 1 1 1 1 1 1 1
