1	1	1	1	1	1	1	1	1	1	1	1	1	1	1	1	1				1	1	1	1	1	1	1	1
1	1	1	1	1	1	1	1	1	1	1	1					1	1	1	1	1						e	1
1			c	z									p			1	c	b	a	1							1
1	z															1								e			1
1			1	1		1	1	1	1		1					1			b	b	1						1
1			1	1		b	a	a	b		1	1	1	1	1	1			1	1	1				e		1
1		z	1	1	1	1	1	1	1	1	1	1	1	1					1	1			e				1
1			1	1	h	a						a	h	1		e			1	1			c		c	e	1
1			1	1		P						P		1				e	1	1	1	1	1		1	1	1
1		e	1	1										1		2			e	a	1						1
1	z		1	1												2					1						1
1	z		1	1										1							1						1
1		z	1	1	b								b	1	1	1	1	1	1	1	1	c					1
1	l		1	1	1	1	1	1		1	1	1	1	1					1					P			1
1		z	1				1	c		c	1	1	1								1						1
1	z	l	1				1				1	1	1		P						1		l		l		1
1			1	1	1	1	1	e		e	1	1	1			r	1	1	1	1	1						1
1	l				z	h	1				1	1	1				1	b		h	1						1
1		e				c	1				1	1	1		P					a	1		c		c		1
1				z	b	a	1	1		1	1	1	1						e	m	1	1	1		1	1	1
1		l	1	1	1	1	1	c		c	1	1	1	1	1	1	1	1	1	1	1	1	c		1	1	1
1	e		1	1									1		z						z						1
1	z		1	1		l					l		1				z										1
1		z	1	1									1		2	2	2		z		2	2	2	2		z	1
1	c			1				r	r				1	a	2	2	2				2	2	2	2		z	1
1	1	1		1									1	1	2	h	e	e		e	e	h	2	2			1
1	c			1									1	1	2	b		c		c	e	b	2	2		z	1
1	e		1	1		l					l		1	1	1	1	1	1	r	1	1	1	1	1	1	1	1
1			1	1									1	1	1	1	1	1		1	1	1	1		c		1
1	z		1	1	1	1	1	1		1	1		1	1	1	1	1	1		1	1	1	1		P		1
1						c	1	c		c	1			c	1		z	1		1		z	1	l		r	1	1	1
1					z	h	1	e			1			b	1								1	r				e	1
1		z	e			c	1			e	1		e		1	z		1		1	z	z	1				l		1
1		e	1	1	1	1	1		z		1			a	1	1	1	1		1	1	1	1						1
1			1	h	c	a	1				1	h	b	h	1	h	z	1		1	z	a	1					P	1
1		z	1	h		a	1				1	1	1	1	1	z	z				z	z	1			r			1
1			1	b		b	1			1	1				1	b	z	1		1	z	b	1					r	1
1	z									1					1	1	1	1		1	1	1	1						1
1			z			e				1					1	b						b	1						1
1	1	1	1	1	1	1	1	1	1	1					1	r						r	1						1
															1	m						m	1	1		1	1	1	1
															1	1	1	1		1	1	1	1	c		c	1	1	1
																		1							l		1	1	1
																		1	1	1	1	1	1	1	1	1	1	1	1