1	1	1	1	1	1	1	1	1	1	1	1	1	1	1	1	1				1	1	1	1	1	1	1	1
1	1	1	1	1	1	1	1	1	1	1	1					1	1	1	1	1						e	1
1			c										p			1	c	b	a	1							1
1																1								e			1
1			1	1		1	1	1	1		1					1			b	b	1						1
1			1	1		b	a	a	b		1	1	1	1	1	1			1	1	1				e		1
1			1	1	1	1	1	1	1	1	1	1	1	1					1	1			e				1
1			1	1				e					h	1		e			1	1			c		c	e	1
1			1	1										1				e	1	1	1	1	1		1	1	1
1		e	1	1	e		e						c	1					e	a	1						1
1			1	1						1			e								1						1
1	e		1	1						1	a	e	c	1							1						1
1			1	1					e	1	a		b	1	1	1	1	1	1	1	1	c				e	1
1			1	1	1	1	1	1		1	1	1	1	1					1					e			1
1		e	1				1	c		c	1	1	1								1						1
1			1				1				1	1	1								1						1
1			1	1	1	1	1	e		e	1	1	1			r	1	1	1	1	1		e			e	1
1					e	h	1				1	1	1				1	b		h	1						1
1		e				c	1				1	1	1							a	1		c	e	c		1
1				e	b	a	1	1		1	1	1	1						e	m	1	1	1		1	1	1
1			1	1	1	1	1	c		c	1	1	1	1	1	1	1	1	1	1	1	1	c		1	1	1
1	e		1	1		e						e	1														1
1			1	1									1		2	2	2				2	2	c			e	1
1			1	1									1		2	h	e				e	h	2				1
1	c			1			r				r		1	a	2	b	e	c		c	e	b	2			e	1
1	1	1		1									1	1	1	1	1	1	r	1	1	1	1	1	1	1	1
1	c			1									1					1		1			1	e	c	e	1
1	e		1	1									1		1	1	1	1		1	1	1	1				1
1			1	1									1		1		e	1		1			1	1		1	1	1	1
1			1	1	1	1	1	1		1	1		1	1	1								1	r				e	1
1						c	1	c		c	1			c	1			1		1	e		1						1
1					e	h	1	e			1			b	1	1	1	1		1	1	1	1						1
1			e			c	1			e	1		e		1	h		1		1	e	a	1						1
1		e	1	1	1	1	1		e		1			a	1								1			r			1
1			1	h	c	a	1				1	h	b	h	1	b	e	1		1		b	1					r	1
1			1	h		a	1				1	1	1	1	1	1	1	1		1	1	1	1						1
1			1	b		b	1			1	1				1	b						b	1						1
1	e									1					1	r						r	1						1
1			e			e				1					1	m						m	1	1		1	1	1	1
1	1	1	1	1	1	1	1	1	1	1					1	1	1	1		1	1	1	1	c		c	1	1	1
																		1				r					1	1	1
																		1	1	1	1	1	1	1	1	1	1	1	1