1	1	1	1	1	1	1	1	1	1	1	1	1	1	1	1	1	1	1	1
1				2															1
1		p		2							e								1
1				2				e							e			e	1
1			c	2							e								1
1													e						1
1	b	a	c	2							c				c		b	h	1
1	2	2	2	2	2	2	2	2	2	2	2				2	2	2	2	1
1		e					2	h		a	2				2	a	h	e	1
1								2		b	2				2	b			1
1				e		2					2				2	e			1
1						2	c			2	2	c			2	1	1		1
1		e				2													1
1						2													1
1			e			2	c			2	2	c			2	1			1
1						2			2		2				2				1
1	e							2			2				2		1	1	1
1		c					2				2				2				1
1		2	2	2	2	2			r		2				2		e	e	1
1											2				2	e	h	b	1
1	1	1	1	1	1	1	1	1	1	1	1	1	1	1	1	1	1	1	1