Map Width: 39
Map Height: 29
Next Level: Level3

0 0 0 0 0 0 0 0 0 0 0 0 0 0 0 0 0 0 0 0 0 0 0 0 0 0 0 0 0 0 0 0 0 0 0 0 0 0 0
0 1 0 0 0 0 0 0 0 0 0 0 0 0 0 0 0 1 1 1 1 0 0 0 0 0 0 0 0 0 0 0 0 0 0 0 0 0 0
0 1 0 0 0 0 0 0 0 1 1 1 1 1 1 1 1 1 1 1 1 1 0 0 0 1 1 1 0 0 1 0 0 0 0 0 0 0 0
0 1 0 0 0 0 0 0 1 1 1 1 1 1 0 1 0 1 0 0 0 1 0 0 1 1 1 1 1 0 1 0 0 0 0 0 0 0 0
0 1 0 0 0 0 0 1 1 1 0 0 1 1 0 1 0 1 1 1 1 1 1 1 1 1 1 1 1 0 1 1 1 1 1 1 1 1 0
0 1 0 1 1 1 1 1 1 1 0 0 1 1 0 1 0 1 1 1 1 1 1 1 1 1 1 1 1 0 1 1 1 1 1 1 1 1 0
0 1 0 1 1 1 1 1 1 0 0 0 1 1 0 1 1 1 1 1 1 1 0 0 1 1 1 1 1 0 1 1 1 0 0 0 1 1 0
0 1 0 1 1 1 1 1 1 0 1 1 1 0 0 1 1 1 0 1 1 1 0 0 0 1 1 1 0 0 1 1 1 1 1 0 1 1 0
0 1 0 0 0 0 0 0 0 0 1 1 1 0 0 1 1 1 1 1 1 1 0 0 0 0 0 0 0 0 1 1 1 1 1 0 1 1 0
0 1 0 0 0 0 0 0 0 0 1 0 0 0 0 1 1 1 1 1 1 1 0 0 0 1 1 1 0 0 1 1 0 1 1 1 1 1 0
0 1 1 0 1 1 1 1 1 1 1 1 1 1 0 1 1 1 1 1 1 1 0 0 1 1 1 1 1 0 1 1 0 1 1 1 1 1 0
0 1 1 0 1 1 1 1 1 1 1 1 1 1 0 1 1 1 0 1 1 1 1 1 1 1 1 1 1 1 1 0 0 1 0 1 1 1 0
0 1 1 0 1 1 1 1 1 1 1 0 0 1 0 1 1 1 1 1 1 1 1 1 1 1 1 1 1 1 1 0 1 1 0 1 1 1 0
0 1 1 0 0 0 0 0 0 0 1 0 1 1 0 1 1 1 1 1 1 1 0 0 1 1 1 1 1 0 1 1 1 1 1 1 1 1 0
0 1 1 1 1 1 1 1 1 0 0 0 1 1 0 1 1 1 1 1 1 1 0 0 0 1 1 1 0 0 1 1 1 0 1 1 0 1 0
0 1 1 1 1 1 1 1 1 0 1 1 1 1 0 1 1 1 0 1 1 1 0 0 0 0 0 0 0 0 1 1 0 0 1 1 1 1 0
0 1 1 0 0 0 0 1 1 0 1 1 0 0 0 1 1 1 1 1 1 1 0 0 0 0 0 0 0 0 1 1 1 1 1 1 1 1 0
0 1 1 0 0 0 0 1 1 0 1 1 1 0 0 1 1 1 1 1 1 1 0 0 1 1 1 1 1 0 0 0 0 0 0 0 1 1 0
0 0 0 0 0 0 0 1 1 0 1 1 1 0 0 1 1 1 1 1 1 1 1 1 1 1 1 1 1 0 0 0 0 0 0 0 1 1 0
0 0 0 0 0 0 0 1 1 1 1 1 1 0 0 0 1 1 0 1 1 1 1 1 1 1 1 1 1 1 1 0 0 0 0 0 1 1 0
0 0 0 0 0 0 0 1 1 1 1 1 1 1 1 0 1 1 1 1 1 1 0 0 1 1 1 1 1 0 0 0 0 0 0 0 1 1 0
0 0 0 0 0 0 0 0 0 0 1 1 1 0 0 0 1 1 1 1 1 1 0 0 0 0 0 0 0 0 0 0 0 0 0 0 1 1 0
0 0 0 0 0 0 0 0 0 0 0 0 0 0 0 0 0 0 0 0 0 0 0 0 0 0 0 0 0 0 0 0 0 0 0 0 1 1 0
0 0 0 0 0 0 0 0 0 0 0 0 0 0 0 0 0 0 0 0 0 0 0 0 0 0 1 1 1 1 1 1 1 1 1 1 1 1 0
0 0 0 0 0 0 0 0 0 0 0 0 0 0 0 0 0 0 0 1 1 1 1 1 1 1 1 1 1 1 1 1 1 1 1 1 1 1 0
0 0 0 0 0 0 0 0 0 0 0 1 1 1 1 1 1 1 1 1 1 1 1 1 1 1 1 1 1 1 1 1 1 1 1 1 1 1 0
0 0 0 0 0 0 0 0 0 0 0 0 0 0 0 0 0 0 0 1 1 1 1 1 1 1 1 1 1 1 1 1 1 1 1 1 1 1 0
0 0 0 0 0 0 0 0 0 0 0 0 0 0 0 0 0 0 0 0 0 0 0 0 0 0 1 1 1 1 1 1 1 1 1 1 1 1 0
0 0 0 0 0 0 0 0 0 0 0 0 0 0 0 0 0 0 0 0 0 0 0 0 0 0 0 0 0 0 0 0 0 0 0 0 0 0 0
1 1 1 1 1 1 1 1 1 1 1 1 1 1 1 1 1 1 1 1 1 1 1 1 1 1 1 1 1 1 1 1 1 1 1 1 1 1 1
1 0 1 1 1 1 1 1 2 2 2 2 2 2 2 2 2 0 ! 0 0 2 1 1 1 1 1 1 1 1 1 1 1 1 1 1 1 1 1
1 0 1 1 1 1 1 2 2 0 0 0 Z 0 0 0 0 0 0 0 ! 0 1 1 1 0 Z S 1 1 S 1 1 1 1 1 1 1 1
1 0 1 1 1 1 2 2 ! Z 0 0 0 0 1 0 2 0 2 2 2 0 1 1 0 0 0 X 0 1 [ 1 1 1 1 1 1 1 1
1 0 1 1 2 2 2 0 0 0 1 1 0 0 1 0 2 0 0 0 Z 0 0 0 0 0 ! 0 0 1 ! 0 0 0 ! 0 0 0 1
1 0 1 0 0 0 0 0 0 0 1 1 0 0 1 0 2 ! 0 0 0 0 0 0 0 * 0 0 0 1 0 Z 0 0 0 0 Z 0 1
1 0 1 0 X 0 0 0 0 1 1 1 0 0 1 Z 0 0 0 0 0 0 1 1 0 0 0 0 0 1 0 0 0 2 2 2 0 X 1
1 0 1 0 0 0 0 ! Z 1 0 0 0 1 1 0 0 0 2 0 0 0 1 1 1 0 Z 0 1 1 0 0 0 0 0 2 ! 0 1
1 ] 1 1 1 1 1 1 1 1 0 0 0 1 1 0 0 0 0 0 Z 0 1 1 1 1 1 1 1 1 0 0 0 ! 0 2 0 0 1
1 O 1 1 1 1 1 1 1 1 0 1 1 1 1 0 0 0 0 0 0 0 1 1 1 0 q 0 1 1 0 0 2 0 Z 0 0 0 1
1 0 @ 1 # 0 * ! 0 0 0 0 0 0 1 0 0 0 0 0 ! @ 1 1 0 0 0 0 0 1 0 0 2 0 0 0 0 0 1
1 0 0 1 s 0 0 0 0 0 0 0 0 0 1 0 0 0 2 0 0 0 0 0 0 0 0 0 Z 0 0 2 2 0 2 0 Z 0 1
1 0 0 1 # 0 0 0 0 * q 1 1 0 1 0 0 0 0 0 0 0 0 0 0 Z 0 0 0 0 0 2 0 0 2 0 0 0 1
1 0 ! 1 1 1 1 1 1 1 ! 1 0 0 1 0 * Z 0 0 0 @ 1 1 0 0 0 Z 0 1 0 0 0 0 0 0 0 X 1
1 0 0 0 0 0 0 0 * 1 1 1 0 0 1 0 0 0 ! 0 0 0 1 1 1 0 w 0 1 1 0 0 0 2 ! 0 2 0 1
1 0 0 0 * 0 0 Z 0 1 ! Z 0 0 1 0 0 0 2 0 0 0 1 1 1 1 1 1 1 1 0 ! 2 2 Z 0 0 0 1
1 0 0 1 1 1 1 0 0 1 0 0 2 2 1 0 0 0 0 0 0 0 1 1 1 1 1 1 1 1 0 0 0 0 0 0 Z 0 1
1 ! 0 1 1 1 1 0 0 1 0 0 * 2 1 0 ! 0 0 0 0 Z 1 1 0 0 0 ! 0 1 1 1 1 1 1 1 0 0 1
1 1 1 1 1 1 1 0 0 1 0 0 0 2 2 0 0 0 0 * 0 0 0 0 0 0 0 0 0 1 1 1 1 1 1 1 0 0 1
1 1 1 1 1 1 1 0 0 0 * 0 0 2 2 2 Z 0 2 0 0 0 0 0 0 0 0 X ! [ q 1 1 1 1 1 0 0 1
1 1 1 1 1 1 1 0 0 Z 0 0 ! [ w 2 0 0 0 0 ! 0 1 1 Z ! 0 0 0 1 1 1 1 1 1 1 0 0 1
1 1 1 1 1 1 1 1 1 1 ! Z 0 2 2 2 0 0 0 0 0 0 1 1 1 1 1 1 1 1 1 1 1 1 1 1 0 0 1
1 1 1 1 1 1 1 1 1 1 1 1 1 1 1 1 1 1 1 1 1 1 1 1 1 2 2 2 2 1 1 1 1 1 1 1 0 0 1
1 1 1 1 1 1 1 1 1 1 1 1 1 1 1 1 2 2 2 2 2 2 2 2 2 2 @ 0 Z 0 0 0 0 0 0 Z 0 0 1
1 1 1 1 1 1 1 1 1 1 2 2 2 2 2 2 2 2 2 @ 0 X 0 0 Z 0 0 0 0 0 0 Z 0 0 0 0 0 0 1
1 1 1 1 1 1 1 1 1 1 2 0 0 0 0 0 0 0 ] 0 0 0 0 0 0 0 0 0 0 0 0 0 0 0 0 0 0 0 1
1 1 1 1 1 1 1 1 1 1 2 2 2 2 2 2 2 2 2 @ 0 X 0 0 0 0 0 0 0 ! 0 0 0 Z 0 0 0 0 1
1 1 1 1 1 1 1 1 1 1 1 1 1 1 1 1 2 2 2 2 2 2 2 2 2 2 @ Z 0 0 0 0 * 0 0 0 0 0 1
1 1 1 1 1 1 1 1 1 1 1 1 1 1 1 1 1 1 1 1 1 1 1 1 1 2 2 1 1 1 1 1 1 1 1 1 1 1 1
