Map Width: 44
Map Height: 33
Next Level: Level5

0 0 0 0 0 0 0 0 0 0 0 0 0 0 0 0 0 0 0 0 0 0 0 0 0 0 0 0 0 0 0 0 0 0 0 0 0 0 0 0 0 0 0 0
0 0 0 0 0 0 1 1 1 1 0 1 1 1 0 1 1 1 1 0 1 1 1 1 1 1 1 1 1 1 1 1 1 1 1 1 1 1 1 0 0 0 0 0
0 0 1 1 1 1 1 1 1 1 1 1 1 1 0 1 0 1 1 0 1 1 1 1 1 1 1 1 1 1 1 1 1 1 1 1 1 1 1 0 0 0 0 0
0 0 0 0 0 0 1 1 1 1 0 1 1 1 1 1 0 1 1 1 1 1 1 1 1 1 1 1 1 1 1 1 1 1 1 1 1 1 1 0 0 0 0 0
0 0 0 0 0 0 0 1 0 0 0 1 1 1 0 1 0 1 1 0 1 1 1 1 1 1 1 1 1 1 1 1 1 1 1 1 1 1 1 0 0 0 0 0
0 0 1 1 1 1 1 1 1 1 1 1 1 1 0 1 1 1 1 0 1 1 1 1 1 1 1 1 1 1 1 1 1 1 1 1 1 1 1 0 0 0 0 0
0 0 1 1 1 0 0 0 0 0 0 0 0 0 0 0 0 0 0 0 0 0 0 0 0 0 0 0 0 0 1 1 1 0 0 1 0 1 1 0 0 0 0 0
0 0 1 1 1 0 0 0 0 0 1 1 1 1 1 1 0 0 0 0 0 0 0 0 0 0 0 0 0 0 1 1 1 0 1 1 0 1 1 0 0 0 0 0
0 1 1 1 1 1 0 0 0 0 1 0 0 0 0 1 0 0 0 0 0 1 1 1 1 1 1 1 1 0 1 1 1 0 0 0 0 1 1 0 0 0 0 0
0 1 1 1 1 1 0 1 1 1 1 1 1 1 0 1 0 0 0 0 0 1 1 1 1 1 1 1 1 0 1 1 1 0 0 0 0 1 1 0 0 0 0 0
0 1 1 1 1 1 0 1 1 1 1 1 1 1 0 1 0 0 0 0 0 1 1 1 1 1 1 1 1 0 0 0 0 0 0 0 0 1 1 0 0 0 0 0
0 1 1 1 1 1 0 1 1 1 1 1 1 1 0 1 1 1 1 0 1 1 1 1 1 1 1 1 1 0 1 1 1 1 1 1 1 1 1 0 0 0 0 0
0 1 1 1 1 1 0 1 1 1 1 1 1 1 0 1 1 1 1 1 1 1 1 1 1 1 1 1 1 1 1 1 1 1 1 1 1 1 1 0 0 0 0 0
0 1 1 1 1 1 0 1 1 1 1 1 1 1 0 1 1 1 1 0 1 1 1 1 1 1 1 1 1 0 1 1 1 1 1 1 1 1 1 0 0 0 0 0
0 1 1 1 1 1 0 1 1 1 1 1 1 1 0 0 0 0 0 0 0 1 1 1 1 1 1 1 1 0 0 0 0 0 0 0 0 0 0 0 0 0 0 0
0 1 1 1 1 1 0 1 1 1 1 1 1 1 0 0 0 0 0 0 0 1 1 1 1 1 1 1 1 1 1 1 1 1 1 0 0 0 0 0 0 0 0 0
0 1 1 1 1 1 0 1 1 1 1 1 1 1 0 0 0 0 0 0 0 0 0 0 0 0 0 0 0 0 1 1 1 1 1 0 0 0 0 0 0 0 0 0
0 1 1 1 1 1 0 0 0 0 1 0 0 0 0 1 1 1 1 1 0 1 1 1 1 0 0 0 0 0 1 1 1 1 1 0 0 0 0 0 0 0 0 0
0 1 1 1 1 1 0 1 1 1 1 1 0 1 1 1 1 1 1 1 0 1 1 1 1 1 1 0 0 0 0 0 0 0 0 0 0 0 0 0 0 0 0 0
0 0 0 0 0 0 0 1 1 1 1 1 0 1 1 1 1 1 1 1 0 1 1 1 1 1 1 0 0 0 1 1 1 0 1 1 1 0 1 1 1 0 0 0
0 0 1 1 1 1 1 1 1 1 1 1 0 1 1 1 0 0 1 0 0 1 1 1 1 1 1 0 0 0 1 1 1 0 1 1 1 0 1 1 1 0 1 0
0 0 1 1 1 1 1 1 1 1 1 1 0 1 1 1 0 1 1 1 0 1 1 1 1 1 1 0 0 0 0 1 0 0 0 1 0 0 1 1 1 0 1 0
0 0 1 1 1 0 0 0 0 1 1 1 0 0 1 1 0 1 1 1 0 1 1 1 1 1 1 1 1 1 1 1 1 1 1 1 1 1 1 1 1 1 1 0
0 0 0 1 1 0 0 0 0 1 1 1 0 1 1 1 0 1 1 1 0 1 1 1 1 1 1 0 0 0 0 1 0 0 0 1 0 0 1 1 1 0 1 0
0 1 1 1 1 1 1 1 0 0 0 0 0 1 0 0 0 0 0 0 0 1 1 1 1 1 1 0 0 0 1 1 1 0 1 1 1 0 1 1 1 0 1 0
0 1 1 1 1 1 1 1 0 1 1 1 1 1 1 1 1 1 1 0 0 1 1 1 1 1 1 0 0 0 1 1 1 0 1 1 1 0 1 1 1 0 1 0
0 1 1 1 1 1 1 1 0 1 1 1 1 1 1 1 1 1 1 0 1 1 1 1 1 1 1 0 0 0 0 0 0 0 0 0 0 0 0 0 0 0 1 0
0 1 1 1 1 1 1 1 1 1 1 1 1 1 1 1 1 1 1 1 1 1 1 1 1 1 1 0 1 1 1 0 1 1 1 1 1 1 1 1 0 1 1 0
0 1 1 1 1 1 1 1 0 1 1 1 1 1 1 1 1 1 1 0 0 1 1 1 1 1 1 0 1 1 1 1 1 1 1 1 1 1 0 1 1 1 1 0
0 1 1 1 1 1 1 1 0 1 1 1 1 1 1 1 1 1 1 0 0 1 1 1 1 1 1 0 1 1 1 0 1 1 1 1 1 1 0 1 0 1 1 0
0 0 0 0 0 0 0 0 0 0 0 0 0 0 0 0 0 0 0 0 0 0 0 0 0 0 0 0 1 1 1 0 1 1 1 1 1 1 0 1 0 0 0 0
1 1 1 1 1 1 1 1 0 1 1 1 1 1 1 1 1 1 1 1 1 1 1 1 1 1 1 1 1 1 1 0 1 1 1 1 1 1 0 1 0 0 0 0
1 1 1 1 1 1 1 1 0 0 0 0 0 0 0 0 0 0 0 0 0 0 0 0 0 0 0 0 0 0 0 0 0 0 0 0 0 0 0 0 0 0 0 0
1 1 1 1 1 1 1 1 1 1 1 1 1 1 1 1 1 1 1 1 1 1 1 1 1 1 1 1 1 1 1 1 1 1 1 1 1 1 1 1 1 1 1 1
1 1 1 1 1 1 0 ! 0 @ 1 0 0 0 1 0 0 0 0 1 0 0 0 ! 0 0 0 0 Z 0 0 0 0 0 0 0 0 0 0 1 1 1 1 1
1 1 0 0 0 0 O 0 0 0 0 0 0 0 1 0 1 0 @ 1 0 0 0 Z 0 0 0 0 0 0 X 0 0 0 0 ! 0 0 0 1 1 1 1 1
1 1 1 1 1 1 0 0 0 @ 1 0 ! 0 0 0 1 0 0 0 0 0 0 0 0 0 ! 0 C 0 0 0 0 0 Z 0 0 0 0 1 1 1 1 1
1 1 1 1 1 1 1 0 1 1 1 0 0 0 1 0 1 0 @ 1 0 0 0 0 0 0 Z 0 0 0 0 0 ! 0 0 0 0 0 0 1 1 1 1 1
1 1 0 Z 0 0 0 0 0 0 0 Z 0 Z 1 0 0 0 0 1 0 0 Z ! 0 0 0 0 0 0 0 X 0 Z 0 0 0 0 * 1 1 1 1 1
1 1 0 0 Z 1 1 1 1 1 1 1 1 1 1 1 1 1 1 1 1 1 1 1 1 1 1 1 1 1 0 0 0 1 1 [ 1 0 0 1 1 1 1 1
1 1 Z 0 0 1 1 1 1 1 0 0 0 0 0 0 1 1 1 1 1 1 1 1 1 1 1 1 1 1 0 0 0 1 S F 1 * 0 1 1 1 1 1
1 # 0 * 0 # 1 1 1 1 0 1 1 1 1 0 1 1 1 1 1 0 0 0 0 Z 0 0 0 1 0 0 0 1 1 1 1 0 0 1 1 1 1 1
1 0 0 0 * 0 1 0 * 0 0 0 ! 0 1 0 1 1 1 1 1 0 0 0 0 0 0 Z 0 1 q # w 1 1 1 1 0 0 1 1 1 1 1
1 # 0 0 0 # 1 0 ! 0 0 0 0 0 1 0 1 1 1 1 1 0 Z 0 0 ! 0 0 0 1 1 1 1 1 1 1 1 0 * 1 1 1 1 1
1 0 0 0 0 0 1 * 0 0 0 Z 0 0 1 0 # q w 1 # 0 0 0 0 0 Z 0 0 1 D 0 * 0 * 0 0 * 0 1 1 1 1 1
1 # 0 0 0 # 1 V * 0 0 0 0 ! 1 0 0 0 0 0 0 0 0 ! 0 0 0 0 0 0 0 0 B * 0 0 0 0 0 1 1 1 1 1
1 0 * 0 0 0 1 ! 0 0 0 0 0 0 1 0 # q w 1 # ! 0 0 Z 0 0 0 0 1 D * 0 0 0 0 * 0 0 1 1 1 1 1
1 # 0 0 0 # 1 0 Z 0 0 0 0 V 1 1 1 1 1 1 1 0 0 0 0 ! 0 Z 0 1 1 1 1 1 1 1 1 1 1 1 1 1 1 1
1 0 0 * 0 0 1 0 0 0 0 0 ! * 1 1 1 1 1 1 1 0 0 ! 0 0 0 ! 0 0 * 0 ! 0 0 1 1 1 1 1 1 1 1 1
1 # 0 0 0 # 1 0 ! 0 0 0 Z 0 1 1 1 1 1 1 1 1 1 1 1 1 1 1 1 1 0 0 0 * ! 1 1 1 1 1 1 1 1 1
1 0 0 0 0 0 1 1 1 1 0 1 1 1 1 0 0 0 0 Z 1 V 0 0 0 1 1 1 1 1 ! S 0 ! q 1 1 1 1 1 1 1 1 1
1 # S f F # 1 0 0 0 0 0 1 0 0 0 Z 0 0 0 1 0 X 0 0 0 0 1 1 1 1 1 1 1 1 1 1 1 1 1 1 1 1 1
1 1 1 1 1 1 1 0 0 0 0 0 1 0 Z 0 0 0 0 0 1 0 0 0 0 V 0 1 1 1 # S # 1 0 0 0 1 0 z V 1 1 1
1 1 X 0 0 0 0 0 0 0 0 0 1 0 0 0 1 1 0 1 1 Z 0 0 0 0 X 1 1 1 0 Z 0 1 0 0 0 1 0 0 z 1 - 1
1 1 0 0 0 0 0 X 0 ! 0 0 1 0 0 Z 1 ! 0 ! 1 0 0 0 0 0 0 1 1 1 1 0 1 1 1 0 1 1 0 0 0 1 [ 1
1 1 0 0 0 1 1 1 1 0 0 0 1 1 0 0 1 q Z w 1 0 X 0 0 Z 0 0 0 0 0 0 0 0 0 0 0 0 0 Z 0 0 Z 1
1 1 1 0 0 1 1 1 1 0 0 X 1 0 0 0 1 q F w 1 0 0 0 0 0 0 1 1 1 1 0 1 1 1 0 1 1 0 0 Z 1 0 1
1 D D 0 ! 0 0 S 1 1 1 1 1 0 1 1 1 1 1 1 1 0 0 0 0 0 0 1 1 1 q 0 0 1 w 0 0 1 0 0 0 1 0 1
1 0 0 0 0 0 ! F 1 0 0 0 0 0 0 0 0 0 B 1 1 0 0 0 Z 0 0 1 1 1 0 Z 0 1 0 Z 0 1 V 0 z 1 0 1
1 0 ! 0 0 0 0 @ 1 0 0 0 0 * 0 0 0 0 @ 1 0 0 0 0 0 0 X 1 1 1 1 1 1 1 1 1 1 1 1 1 1 1 0 1
1 ! 0 0 0 0 0 0 0 0 0 0 0 0 B 0 0 0 0 0 0 0 0 0 0 0 0 1 0 0 0 1 # 0 Z 0 0 0 0 0 1 @ 0 1
1 0 0 ! 0 0 0 @ 1 0 0 C 0 0 * 0 0 0 @ 1 1 0 0 0 0 0 0 1 0 0 0 X 0 Z 0 0 0 0 1 0 0 0 0 1
1 q w 0 0 ! 0 ! 1 0 0 0 0 0 0 0 0 C 0 1 1 0 0 0 X 0 0 1 B 0 Z 1 # 0 Z 0 Z 0 1 0 1 @ 0 1
1 1 1 1 1 1 1 1 1 1 1 1 1 1 1 1 1 1 1 1 1 1 1 1 1 1 1 1 @ 0 @ 1 X 0 0 0 0 0 1 S 1 1 1 1
0 0 0 0 0 0 0 0 1 0 0 0 0 0 0 0 0 0 0 0 0 0 0 0 0 ] Z 0 0 0 0 1 0 0 0 B 0 0 1 # 1 1 1 1
0 0 0 0 0 0 0 0 1 1 1 1 1 1 1 1 1 1 1 1 1 1 1 1 1 1 1 1 1 1 1 1 1 1 1 1 1 1 1 1 1 1 1 1
