Next Level: None
1	1	1	1	1	1	1	1	1	1	1	1	1	1	1	1	1	1	1	1	1	1	1	1	1	1	1	1	1	1	1	1	1	1	1	1	1	1
1	q		1	!	1	w	!		Z	1	F		O		S	1	1	1	1	1	1	@												@	1		1
1	Z				1	1			S	1					D	1	1	1	1	1	1									*							1
1	1	1	1		1	1		1	1	1	1	1	#			1	1	1	1	1	1			*											1		1
1	Z		Z				*			Z	!	1	1		1	1		!	Z		1						*								1		1
1		*			!			Z				1			*	!		Z		Z	1												*		1		1
1						Z		!	*								Z		*	!	1						*				*		*		1		1
1	1	1	1		1	1	1	1	1	1	1	1	1	1	1	1	1	1	1	[	1			*											1		1
1						Z								Z		1	1	1	1	w	1								N						1		1
1	!		Z			!			Z	!			!			1	1	1	1	1	1				*					*					1		1
1				1	1						1	1				1	1	1	1	1	1														1		1
1	Z			1	1			!	Z		1	1			!	1	1	1	1	1	1														1		1
1			!			Z								Z		1	1	1	1	1	1										*				1		1
1	1	1	1					Z							!	1	1	1	1	1	1			*		*									1		1
1	C		1	1	1	1	1		1	1	1	1	[	1	1	1	1	1	1	1	1														1		1
1	*		q	[	w	1	#		#	1	1	1	F	1	1	1	1	1	1	1	1	@			*									@	1		1
1				1	1	!				!	1	1	1	1	1	1	1	1	1	1	1	1	1	1	1	1	1	1	1	1	1	1		1	1		1
1		*		1	#			*			@	1							@	w	w		@	F	F	@	S	@		@		@		@	1		1
1	D				*			B						*		*			*			*				*					*				1		1
1				1	#				*		@	1							@	q	q		@	D	D	@	S	@		@					1		1
1				1	1	!				!	1	1	1	1	1	1	1	1	1	1	1	1	1	1	1	1	1	1	1	1	1	1	1	1	1		1
1	*			W	1	1	#		#	1	1	1	1	@	Z			Z	C										X								1
1	C	*	1	1	1	1	1	*	1	1			]					Z			1	1	1	1	1	1	1	1			X						1
1	1	1	1				1		1	1	1	1	1	@						1			*		V		F	1	1	1	1	1	1	1	1	1	1
							1		1	1	1		1	1	Z		Z		1							B		1
							1		1	1	1			1	1	q	w	1							*			1
							1	*	1	1	1		#	1	1	1	1		*	*							C	1
							1			*				*			*	*	1			*						1
						1	1	!	1	1	1		#	1	1	1	1								*		C	1
						1	S			q	1			1				1					*				*	1
						1	S			q	1		1	1					1		*					B		1
						1	1	1	1	1	1	1	1							1				*	V		F	1
																					1	1	1	1	1	1	1	1