1	1	1	1	1	1	1	1	1	1	1	1	1
1	b		2						2	b	b	1
1	p					e	1					1
1	a		2				1		2			1
1	2	2	2	2	2		1		2	h	a	1
1	e						1		2	h	a	1
1	1	1	1	1			1		2	2	2	1
1	e						1		1	e	e	1
1	1	1	1	1			1		1		1	1
1	e						1					1
1	1	1	1	1	1		1	1	1		e	1
1	e								1			1
1	1	1	1	1	1	1			1		e	1
1	e								1			1
1	1	1	1	1	1	1	1		1		1	1
1	e								1	e	e	1
1	1	1	1	1	1	1	1	1	1	1	1	1