1	1	1	1	1
1	p	a	b	1
1	2	2		1
1	e			1
1		1	1	1
1			e	1
1	2	2		1
1	e			1
1		1	1	1
1			e	1
1	1	1	1	1