1	1	1	1	1	1	1	1	1	1	1	1	1	1	1	1	1	1	1	1	1	1	1
1						1	h			h			h			h			h			1
1	c		c	1		1															a	1
1	h		a	1		1																1
1	h		a	1																		1
1	h		a	1																	a	1
1	h		a	1																		1
1	b		m	1									r									1
1	c	p	c	1																	a	1
1	h		a	1																		1
1	1	1	1	1																		1
				1																	a	1
				1																		1
				1																		1
				1	1	1	1	1	1	1	1	1	1	1	1	1	1	1	1	1	1	1