Map Width: 13
Map Height: 16
Weapon: Automatic Rifle,Unlocked,360,30
Weapon: Double Shotgun,Unlocked,60,2
Weapon: Revolver,Unlocked,48,8
Next Level: T_Level2

0 0 0 0 0 0 0 0 0 0 0 0 0
0 1 1 1 1 0 0 0 1 1 1 1 0
0 1 1 1 1 0 0 0 1 1 1 1 0
0 0 0 0 1 0 0 0 1 0 0 0 0
0 0 0 0 1 1 1 1 1 0 0 0 0
0 0 0 0 1 1 1 1 1 0 0 0 0
0 1 1 1 1 1 1 1 1 1 1 1 0
0 1 1 1 1 1 1 1 1 1 1 1 0
0 1 1 1 1 1 1 1 1 1 1 1 0
0 1 1 1 1 1 1 1 1 1 1 1 0
0 0 0 0 0 0 1 0 0 0 0 0 0
0 0 1 1 1 1 1 1 1 1 1 0 0
0 0 1 1 0 0 0 0 0 1 1 0 0
0 0 1 1 0 1 1 1 0 1 1 0 0
0 0 1 1 1 1 0 1 1 1 1 0 0
0 0 0 0 0 0 0 0 0 0 0 0 0
1 1 1 1 1 1 1 1 1 1 1 1 1
1 0 0 0 0 Z Z Z 0 0 0 0 1
1 0 0 0 0 Z B Z 0 0 0 0 1
1 Z Z Z 0 Z Z Z 0 Z Z Z 1
1 Z Z Z 0 0 0 0 0 Z Z Z 1
1 Z Z Z 0 0 0 0 0 Z Z Z 1
1 0 0 0 0 0 0 0 0 0 0 0 1
1 0 0 0 0 0 0 0 0 0 0 0 1
1 0 0 0 0 0 0 0 0 0 0 0 1
1 0 0 0 0 0 0 0 0 0 0 0 1
1 1 1 1 1 1 0 1 1 1 1 1 1
1 F 0 0 0 0 0 0 0 0 0 q 1
1 F 0 0 1 1 1 1 1 0 0 q 1
1 F 0 0 @ 0 0 0 @ 0 0 w 1
1 F 0 0 0 0 O 0 0 0 0 w 1
1 1 1 1 1 1 1 1 1 1 1 1 1
