1	1	1	1	1	1	1
1	p				c	1
1	h	a	b	m		1
1	h	a	b	m		1
1	1	1	1	1		1
1						1
1						1
1						1
1						1
1		c			c	1
1		1	1	1	1	1
1						1
1	1	1	1	1		1
1			e			1
1		1	1	1	c	1
1		e		e	1	1
1	1	1	1		1	1
1	e				e	1
1	1	1	1	1	1	1