1	1	1	1	1	1	1	1	1	1	1	1	1	1
1	h		a	1	h							h	1
1	h	p	a	1									1
1	h		a	1					r				1
1	h		a	1									1
1	h		a	1									1
1	h		a	1	h							h	1
1	b		m	1	1	1					1	1	1
1	c		c	1	h	c							1
1				e									1
1	1	1	1	1	1	1	1	1	1	1	1	1	1