1	1	1	1	1	1	1
1	b	a		h	m	1
1	b				m	1
1	b		p		m	1
1	b				m	1
1						1
1		2	2	2	2	1
1					e	1
1	1	1	1	1	1	1