1	1	1	1	1	1	1	1	1	1
1			2			2	b	b	1
1	p						a	a	1
1			2			2	h	h	1
1	2	2	2			2	2	2	1
1						2	2	2	1
1		1	1			2	2	2	1
1		e	1					e	1
1		e	1					e	1
1	1	1	1	1	1	1	1	1	1