Map Width: 50
Map Height: 13
Next Level: T_Level3

0 0 0 0 0 0 0 0 0 0 0 0 0 0 0 0 0 0 0 0 0 0 0 0 0 0 0 0 0 0 0 0 0 0 0 0 0 0 0 0 0 0 0 0 0 0 0 0 0 0
0 0 0 0 0 0 0 0 0 0 0 0 0 0 0 1 1 1 1 0 0 1 1 1 1 1 1 0 0 0 0 0 0 0 0 0 0 0 0 0 0 0 1 1 1 0 0 0 0 0
0 0 0 0 0 0 0 0 0 0 0 0 0 0 0 1 1 1 1 1 1 1 1 1 1 1 1 0 0 0 0 0 0 0 0 0 0 0 0 0 0 1 1 1 1 1 0 0 0 0
0 0 0 0 1 1 1 1 1 1 1 0 0 0 0 1 1 1 1 0 0 1 1 1 1 1 1 0 0 0 0 0 0 0 0 0 0 0 0 0 1 1 1 1 1 1 1 0 0 0
0 0 0 0 1 1 1 1 1 1 1 0 0 0 0 0 0 0 0 0 0 1 1 1 1 1 1 0 1 1 1 1 1 1 0 0 0 0 0 1 1 1 1 1 1 1 1 1 0 0
0 0 0 0 1 1 1 1 1 1 1 1 1 1 1 1 1 1 1 1 1 1 1 1 1 1 1 1 1 1 1 1 1 1 0 0 0 0 1 1 1 1 1 1 1 1 1 1 1 0
0 0 0 0 1 1 1 1 1 1 1 0 0 0 0 0 0 0 0 0 0 1 1 1 1 1 1 1 1 1 1 1 1 1 1 1 1 1 1 1 1 1 1 1 1 1 1 1 1 0
0 0 0 0 1 1 1 0 1 1 1 0 0 0 0 0 0 0 0 0 0 1 1 1 1 1 1 1 1 1 1 1 1 1 0 0 0 0 1 1 1 1 1 1 1 1 1 1 1 0
0 0 0 0 1 1 1 0 1 1 1 0 0 0 0 0 0 0 0 0 0 1 1 1 1 1 1 0 1 1 1 1 1 1 0 0 0 0 0 1 1 1 1 1 1 1 1 1 0 0
0 0 0 0 1 1 1 0 0 1 1 0 0 0 0 1 1 1 1 0 0 1 1 1 1 1 1 0 0 0 0 0 0 0 0 0 0 0 0 0 1 1 1 1 1 1 1 0 0 0
0 1 1 1 1 1 1 1 1 1 1 1 1 1 1 1 1 1 1 1 1 1 1 1 1 1 1 0 0 0 0 0 0 0 0 0 0 0 0 0 0 1 1 1 1 1 0 0 0 0
0 0 0 0 0 0 0 0 0 0 0 0 0 0 0 1 1 1 1 0 0 1 1 1 1 1 1 0 0 0 0 0 0 0 0 0 0 0 0 0 0 0 1 1 1 0 0 0 0 0
0 0 0 0 0 0 0 0 0 0 0 0 0 0 0 0 0 0 0 0 0 0 0 0 0 0 0 0 0 0 0 0 0 0 0 0 0 0 0 0 0 0 0 0 0 0 0 0 0 0
1 1 1 1 1 1 1 1 1 1 1 1 1 1 1 1 1 1 1 1 1 1 1 1 1 1 1 1 1 1 1 1 1 1 1 1 1 1 1 1 1 1 1 1 1 1 1 1 1 1
1 1 1 1 1 1 1 1 1 1 1 1 1 1 1 Z 0 0 0 1 1 0 0 0 * 0 0 1 1 1 1 1 1 1 1 1 1 1 1 1 1 1 0 0 X 1 1 1 1 1
1 1 1 2 2 2 2 2 2 2 2 2 1 1 1 0 0 0 0 0 0 0 0 Z 0 0 0 1 1 1 1 1 1 1 1 1 1 1 1 1 1 0 ! * 0 0 1 1 1 1
1 1 1 2 @ a s d f ! @ 2 1 1 1 0 0 0 0 1 1 0 0 0 0 ! 0 1 1 1 1 1 1 1 1 1 1 1 1 1 0 0 0 0 X 0 0 1 1 1
1 1 1 2 0 ! 0 0 0 0 0 2 2 2 2 1 1 1 1 1 1 * 0 0 0 0 0 1 @ 0 * 0 0 0 1 1 1 1 1 0 0 0 0 0 0 * 0 0 1 1
1 1 1 2 0 0 0 ! 0 0 0 0 0 0 0 0 0 0 0 0 0 0 0 0 ! 0 0 0 * 0 0 0 ! 0 1 1 1 1 @ 0 X 0 * 0 0 0 * 0 0 1
1 1 1 2 0 0 0 0 0 0 ! 2 2 2 2 2 1 1 1 1 1 0 ! 0 0 0 Z 0 0 0 0 Z 0 0 0 0 0 0 0 0 0 0 0 0 0 0 0 0 0 1
1 1 2 2 0 O 0 2 0 0 0 2 1 1 1 1 1 1 1 1 1 * 0 0 * 0 0 0 0 * 0 0 * 0 1 1 1 1 @ 0 0 0 0 0 * X ! X 0 1
1 1 2 2 0 0 ! 2 0 0 0 2 1 1 1 1 1 1 1 1 1 Z 0 0 0 0 0 1 @ 0 0 ! 0 0 1 1 1 1 1 0 ! * 0 0 0 0 0 0 1 1
2 2 2 2 0 0 0 2 2 0 0 2 2 2 2 ! 0 * 0 1 1 @ 0 0 0 0 Z 1 1 1 1 1 1 1 1 1 1 1 1 1 0 0 0 X 0 * 0 1 1 1
2 0 0 ] 0 0 0 0 0 0 0 0 0 0 0 0 0 0 0 0 0 0 0 * 0 0 0 1 1 1 1 1 1 1 1 1 1 1 1 1 1 0 * 0 ! 0 1 1 1 1
2 2 2 2 1 1 1 1 1 1 1 1 1 1 1 * ! D d 1 1 @ 0 0 0 * 0 1 1 1 1 1 1 1 1 1 1 1 1 1 1 1 0 0 * 1 1 1 1 1
1 1 1 1 1 1 1 1 1 1 1 1 1 1 1 1 1 1 1 1 1 1 1 1 1 1 1 1 1 1 1 1 1 1 1 1 1 1 1 1 1 1 1 1 1 1 1 1 1 1
