1	1	1	1	1	1	1	1	1	1	1	1	1	1	1	1	1	1	1	1	1	1	1
1						2	h			h			h			h			h			1
1	c		c	2		2															a	1
1	h		a	2		2																1
1	h		a	2		1					z				z							1
1	h		a	2		2						z									a	1
1	h	p	a	2		2																1
1	b		m	2		2							z									1
1	c		c	2		2												z			a	1
1	h		a	2						z												1
1	2	2	2	2		2										z						1
1	e					2								z							a	1
1			e			2												z				1
1		e				2																1
1	1	1	1	1	1	1	1	1	1	1	1	1	1	1	1	1	1	1	1	1	1	1